No,Name,Age,Country,2007,2008,Total,More
31,abc31,23,br,55,38,93,something more...
32,abc32,34,fr,65,45,110,something more...
33,abc33,25,br,98,99,197,something more...
34,abc34,24,us,23,77,100,something more...
35,abc35,23,fr,67,55,122,something more...
36,abc36,26,fr,42,29,71,something more...
37,abc37,22,us,69,40,109,something more...
38,abc38,22,br,97,99,196,something more...
39,abc39,23,us,63,66,129,something more...
40,abc40,25,br,88,76,164,something more...
41,abc36,26,fr,42,29,71,something more...
42,abc37,22,us,69,40,109,something more...
43,abc38,22,br,97,99,196,something more...
44,abc39,23,us,63,66,129,something more...
45,abc40,25,br,88,76,164,something more...
46,abc33,25,br,98,99,197,something more...
47,abc34,24,us,23,77,100,something more...
48,abc35,23,fr,67,55,122,something more...
49,abc36,26,fr,42,29,71,something more...
50,abc37,22,us,69,40,109,something more...
51,abc39,23,us,63,66,129,something more...
52,abc40,25,br,88,76,164,something more...
53,abc33,25,br,98,99,197,something more...
54,abc34,24,us,23,77,100,something more...
55,abc35,23,fr,67,55,122,something more...